Fix for | proper fix | fixes found
abonamęt -> abonament -> amonami, baonami, ambonami, anonimat, atomami
agrawce -> agrafce -> sprawa, naprawdę, sprawy, sprawie, prawie
akcesorii -> akcesoriów -> agresorów, kategorią, alegorii, kategorie, kategorii
akfamaryną -> akwamarynem -> katamarana, akwamarynem, akwamarynie, akwamarynom, akwamarynów
aktułalnie -> aktualnie -> maksymalnie, aktualnym, aktualnych, aktualnej, naturalnie
akwariumowy -> akwarystyczny -> akwariowymi, akwariarzowi, kostiumowy, akwarelowy, akwariowym
allegrowiczą -> allegrowiczom -> polerownicza, karierowicza, polerowniczą
allegrowiczy -> allegrowiczów -> polerowniczy
altomatow -> automatów -> automatyki, autokarów, automatem, automaty, automatu
ałkcja -> aukcja -> słowa, pokoju, całej, agencja, życia
ałkcjie -> aukcję -> ludzie, całkiem, głównie, obecnie, właśnie
ampółkę -> ampułkę -> opiekę, spółki, wspólne, dopóki, ameryki
angarzuje -> angażuje -> wykazuje, informuje, organizuje, wskazuje, znajduje
antyrozpryzkową -> antyrozpryskową ->
aódi -> audi -> jak, jest, ale, nie, się
apsolutnie -> absolutnie -> absolutnej, absolutnym, paroletnie, absolutna, absolutną
apsurd -> absurd -> akurat, wśród, spośród, ponad, przed
arafadki -> arafatki -> marynarki, krajami, wypadki, praktyki, prowadzi
Arde Co -> Art Deco -> radnych, trzeci, każdego, trzech, bardzo
ardeko -> Art Deco -> trzeba, przed, tylko, przez, bardzo
aromaterapełtyczne -> aromaterapeutyczne ->
artykół -> artykuł -> aktywu, przyjął, przybył, warunków, środków
atmoswera -> atmosfera -> atmosferko, atmosferom, atomowego, atomowej, atmosferze
atramęcie -> atramencie -> patrzcie, trzeciej, tradycje, otwarcie, strasznie
aukcie -> aukcję -> gdzie, jakie, ludzie, sobie, takie
aukcie -> aukcje -> gdzie, jakie, ludzie, sobie, takie
aukcjia -> aukcja -> punkcie, agencji, stacji, agencja, funkcji
awiędz -> a więc -> wtedy, wiele, przez, kiedy, między
bać -> bądź -> że, to, do, nie, się
bagarznik -> bagażnik -> zagajeniu, zamarzania, zamarznie, barwniki, nagrania
balejarzem -> balejażem -> kolejarzom, baloniarzem, kalendarzem, kolejarza, kolejarze
bąbki -> bombki -> pani, sobie, było, roku, tylko
beasbolóka -> bejsbolówka -> seksuologa, teatrologa, tekstologa, bamboszka, fasolówka
beczółka -> beczułka -> poczęła, toczyła, technika, leczenia, zaczęła
Beder Majer -> biedermeier -> biedermeier
bende -> będę -> jeden, może, tego, mnie, jest
bendzie -> będzie -> jedynie, chodzi, obecnie, ludzie, bardzo
berzowy -> beżowy -> byłoby, sprawy, strony, budowy, bardzo
bescen -> bezcen -> więcej, jesteś, jestem, jeden, jeszcze
beszczelny -> bezczelny -> szczelinę, szczególny, nieszczęsny, szczeliny, szczelnie
bencwale -> bęcwale -> centrale, uchwale, centralne, generał, centrali
bezceler -> bestseller -> bezcenne, bezcelowe, bezczelna, bezczelną, bezcenny
bezcent -> bezcen -> moment, obecnej, pewien, jeżeli, procent
będoł -> będą -> jest, bardzo, jego, tego, było
bęty -> bełty -> jak, jest, tym, nie, się
bęzynowa -> benzynowa -> maszynowy, języków, przybywa, rozmowa, przynosi
bierzący -> bieżący -> zwierząt, miesięcy, bieżącego, miesiąca, pierwszy
bimboniera -> bomboniera -> bombonierek, bombonierkę, bombonierki, bombonierko, inżyniera
biórko -> biurko -> która, który, bardzo, które, tylko
biuzcie -> biuście -> ciebie, wreszcie, siebie, ludzie, jeszcze
blad -> blat -> tak, ale, jak, nie, się
blądyna -> blondyna -> jedyną, jedyna, budowa, zaczyna, badania
blew -> blef -> jak, jest, dla, się, nie
bluska -> bluzka -> miasta, polski, polska, ludzi, kilka
bodajrze -> bodajże -> badawcze, podwórze, teatrze, obszarze, kolarze
bolcy -> bolców -> było, może, przy, pracy, tylko
bonos -> bonus -> mnie, jego, może, tego, było
bódzik -> budzik -> ludzi, ludzie, jednak, bardzo, gdzie
branzoleta -> bransoleta -> bransoletek, bransoletkę, bransoletki, bransoletko, bransoletom
brązoletka -> bransoleta -> bransoletki, bransoletko, brązowego, brązownika, bransoletką
brobinkami -> drobinkami -> zbiornikami, rolnikami, osobnikami, kobietami, problemami
bronsoletę -> bransoletę -> bransoletka, bransoletką, bransoletki, bransoletko, bransoletom
bronzowy -> brązowy -> urodzony, rozmowa, środków, rodziny, rozmowy
brożka -> broszka -> proszę, kilka, przez, trzeba, można
bródny -> brudny -> kiedy, pracy, między, który, bardzo
brudna róż -> brudny róż -> brudnawym, brudnawego, brudnawemu, brudnawych, brudnawymi
brylok -> brelok -> byłem, byłoby, czyli, bardzo, tylko
bulem -> bólem -> było, mnie, może, tylko, przez
bydlencej -> bydlęcej -> odległej, wydatnej, myśleniem, jeleniej, myślenie
cantry -> country -> jakby, panie, należy, cztery, który
cfaniak -> cwaniak -> badania, stanie, chociaż, czasie, jednak
cieszki -> ciężki -> części, wreszcie, zresztą, polski, chodzi
cież -> ciesz -> czy, jak, jest, już, ale
ciękie -> cienkie -> jakie, między, czasie, sobie, takie
chaftki -> haftki -> chętnie, statku, partii, chodzi, chwili
chalasuje -> hałasuje -> alarmuje, handluje, zapisuje, zakasuje, realizuje
chalka -> halka -> czasu, czasie, kilka, chyba, tylko
chalogenowa -> halogenowa -> halogenków, chlorynowa, halogenkowi, halogenowej, halogenowym
chamulec -> hamulec -> hamujący, chałupy, hamująco, chciałem, chłopiec
chandlować -> handlować -> handlowego, handlowym, znajdować, handlowych, handlowej
chawt -> haft -> pani, chyba, oraz, nawet, jest
chcem -> chcę -> tych, przed, mnie, może, przez
cheblowania -> heblowania -> umeblowanie, sterowania, regulowania, kierowania, uregulowania
chełmo-kask -> hełmo-kask -> chełmiakach, chełmiakami
cherb -> herb -> chyba, które, jego, tego, jest
cherbacianego -> herbacianego -> kiełbasianego, ochrzanianego, zgarbaciałego, chruścianego, herbacianemu
chisteryczna -> histeryczna -> historyczny, histerycznie, histerycznym, historycznej, historyczne
chity -> hity -> chyba, więc, mnie, przy, jest
chiszpańskim -> hiszpańskim -> chuligańskim, hiszpańskiemu, hiszpańskiego, hiszpańskich, hiszpańskiej
chlajnoga -> hulajnoga -> chlapnęła, chlasnęła, hulajnogę, hulajnogi, hulajnogo
chlopakowe -> chłopięce -> chwytakowe, czerpakowe, chłopskich, chłopskie, członkowie
chociarz -> chociaż -> chciało, chciałam, chociażby, chciała, chciałem
chociasz -> chociaż -> chciało, chciałam, chociażby, chciała, chciałem
chodowany -> hodowany -> mianowany, notowany, stosowany, stosowane, zbudowany
chomologacja -> homologacja -> homologacyjną, homologacjom, homologacjach, homologacjami, homologacyjna
chonorowe -> honorowe -> chorobową, kolorowe, pokojowe, honorowego, handlowe
chorednalnie -> horrendalnie -> chordofonie, horrendalne, horrendalni, horrendalnie
chospitalizacja -> hospitalizacja -> hospitalizacyjną, hospitalizacjom, hospitalizacjach, hospitalizacjami, hospitalizacyjna
chumor -> humor -> czego, chodzi, chwili, numer, chyba
churtowa -> hurtowa -> sportowy, sportowe, uratować, choroby, choroba
cieczom -> cieczą -> liczba, siedem, rzeczy, ciebie, między
ciencia -> cięcia -> pięciu, części, siebie, obecnie, ciebie
cienżarowy -> ciężarowy -> cetnarowy, cieniałoby, niemiarowy, ciężarówki, ciężarowych
cięką -> cienką -> pięć, jest, roku, tylko, więc
ciongnik -> ciągnik -> czynnika, ciśnienia, piosenki, dziennik, czynnik
cód -> cud -> jak, że, nie, na, się
códowna -> cudowna -> podobno, ludowej, zdrowia, budowa, budowy
curka -> córka -> chyba, roku, oraz, przy, tylko
cut -> cud -> to, do, nie, na, się
cuż -> cóż -> to, do, nie, na, się
cyfronicznego -> cyfrowego -> eufonicznego, bajronicznego, symfonicznego, dyftongicznego, zagranicznego
czciny -> trzciny -> często, czasu, chciał, czasie, cztery
czeba -> trzeba -> przed, jego, tego, przez, jest
czegusz -> czegóż -> części, reguły, czerwca, często, chcesz
czeńści -> części -> czterech, ilości, sześciu, dzieci, często
czeszczy -> trzeszczy -> deszczu, czasach, czerwca, wreszcie, jeszcze
czonku -> trzonku -> coraz, cztery, czasie, znowu, czasu
czójnik -> czujnik -> głównie, członek, części, człowiek, czasie
czułenka -> czółenka -> zmienia, czynienia, członek, dziecka, członków
czyma -> trzyma -> można, tych, było, była, przy
czyszczęce -> czyszczące -> wszczęcie, błyszczący, dziewczęce, czyszczenia, błyszczące
czytać umię -> czytać umiem -> cytochemię, czytaliście, czytałyście, czytaniami, czytankami
daleko sienrzne -> dalekosiężne ->
darójmy -> darujmy -> warstwy, dodajmy, strony, dalszym, zarówno
